100
100
50
50
....................................................................................................
....................................................................................................
....................................................................................................
....................................................................................................
....................................................................................................
....................................................................................................
....................................................................................................
.........###########################################################################################
....................................................................................................
....................................................................................................
....................................................................................................
....................................................................................................
....................................................................................................
....................................................................................................
##########################################################################################..........
....................................................................................................
....................................................................................................
....................................................................................................
....................................................................................................
....................................................................................................
.........###########################################################################################
....................................................................................................
....................................................................................................
....................................................................................................
....................................................................................................
....................................................................................................
....................................................................................................
##########################################################################################..........
....................................................................................................
....................................................................................................
....................................................................................................
....................................................................................................
....................................................................................................
.........###########################################################################################
....................................................................................................
....................................................................................................
....................................................................................................
....................................................................................................
....................................................................................................
....................................................................................................
##########################################################################################..........
....................................................................................................
....................................................................................................
....................................................................................................
....................................................................................................
....................................................................................................
....................................................................................................
.........###########################################################################################
....................................................................................................
....................................................................................................
....................................................................................................
....................................................................................................
....................................................................................................
....................................................................................................
##########################################################################################..........
....................................................................................................
....................................................................................................
....................................................................................................
....................................................................................................
....................................................................................................
.........###########################################################################################
....................................................................................................
....................................................................................................
....................................................................................................
....................................................................................................
....................................................................................................
....................................................................................................
##########################################################################################..........
....................................................................................................
....................................................................................................
....................................................................................................
....................................................................................................
....................................................................................................
.........###########################################################################################
....................................................................................................
....................................................................................................
....................................................................................................
....................................................................................................
....................................................................................................
....................................................................................................
##########################################################################################..........
....................................................................................................
....................................................................................................
....................................................................................................
....................................................................................................
....................................................................................................
....................................................................................................
....................................................................................................
.........###########################################################################################
....................................................................................................
....................................................................................................
....................................................................................................
....................................................................................................
....................................................................................................
....................................................................................................
##########################################################################################..........
....................................................................................................
....................................................................................................
....................................................................................................
....................................................................................................
