10
10
10
10
10
10
1 5 5 0 9 0 9
1 0 9 5 5 0 9
1 0 9 0 9 5 5
0 5 5 2 3 7 8
0 6 8 2 3 5 5
0 3 4 2 3 5 5
0 6 8 6 8 5 5
0 3 4 5 5 3 7
0 7 8 5 5 1 2